11111111111111111111111111111111111111111111111111111111111111111111111
10000000000000001000001000000000000000010000000000000000000000000000001
10000001000000001000001000000000000000010000000000000000000000000000001
1000000100000000100000100000000000000001000000000000000C000000000000001
10000001000000001000001000000000000000010000000000000000000000000000001
10000001000000001000001000000000000000010000000000000000000000000000001
10000001000000001000001000000000000100010000000000000000000000000000001
10000001000000001000001000000000000100000000000000000000000000000000001
10000001000000001000001000000000000100000000000000000000000000000000001
10000001000000001000001000000000000100000000000000000000000000000000001
10000001000000000000001000000000000100000000000000000000000000000000001
10000001000000000000001000000000000100000010000000000000000000000000001
100000010000000000C00010000000C0000100000010000000000000000000000000001
10000001000000000000001000000000000100000010000000000000000000000000001
10000001000000000000001000000000000100000010000000000000000000000000001
10000001000000000000001000000000000100000010000000000000000000000000001
10000001000100000000001000000000000100000010000000000000000000000000001
10000000000100000000001000000000000100000010000000000000000000000000001
10000001000100000000001000000000000100000010000000000000000000000000001
10000001000100000000001000000000000100000010000000000000000000000000001
10000001000100000000001000000000000100000010000000000000000000000000001
10000001000100000000001000000000000111111110000000000000000000000000001
10000001000100000000001000000000000100000000000000000000000000000000001
100P00010001111111111110000000000001000000000000000000E0000000000000001
10000001000000000000000000000000000100000000000000000000000000000000001
11111111111111111111111111111111111111111111111111111111111111111111111