11111111111111111111111
10000000000000P0000001
100000C0000000000000001
100000001000E0000000001
11111111111111111111111