11111111111111111111111
10000000000000P00000001
100000C0000000000000001
10000000100000000000001
11111111111111111111111