1111111111111
10000000000C1
1000000P00001
1000011111001
1P0011E000001
1111111111111