11111111111111111111111111111111111
110000000C00011000000000000E0000001
10000000000000110000000000000000001
10000C000000000011100000000C0000001
100000000P0000000000000000000000001
11111111111111111111111111111111111